{
  "0": "x2",
  "1": "x3",
  "2": "x4",
  "3": "x5",
  "4": "x6",
  "5": "x7",
  "6": "x8",
  "7": "x9",
  "8": "x10",
  "9": "xk",
  "10": "xq",
  "11": "backside",
  "12": "q2",
  "13": "q3",
  "14": "q4",
  "15": "q5",
  "16": "q6",
  "17": "q7",
  "18": "q10",
  "19": "qa",
  "20": "qj",
  "21": "qk",
  "22": "qq",
  "23": "s2",
  "24": "s3",
  "25": "s4",
  "26": "s5",
  "27": "s8",
  "28": "s9",
  "29": "s10",
  "30": "sa",
  "31": "sj",
  "32": "sk",
  "33": "sq",
  "34": "g2",
  "35": "g3",
  "36": "g6",
  "37": "g7",
  "38": "g8",
  "39": "g9",
  "40": "g10",
  "41": "ga",
  "42": "gj",
  "43": "gk",
  "44": "gq",
  "45": "xa",
  "46": "xj",
  "47": "q8",
  "48": "q9",
  "49": "s6",
  "50": "s7",
  "51": "g4",
  "52": "g5"
}